"CyUfjTpoIgNghGlqfz9aEw"	["Mexican", "Restaurants"]
"CrjZoiaRdFivE1esbkQ7sw"	[]
"CGQaOhJEQAbvdIE67CHr1Q"	["Tobacco Shops", "Shopping"]
"CxYMVhOnWQuYaVv7wTAiAg"	["Hair Salons", "Nail Salons", "Hair Removal", "Beauty and Spas"]
"Cd_JVOq_cBueqB9q3X0rkQ"	["Flowers & Gifts", "Shopping", "Florists"]
"C8Y9hSU5VjQLNH9rRGKJLQ"	["Dentists", "Cosmetic Dentists", "Health and Medical"]
"Ci-Lqfacr2OHg6OwHEloSg"	["Cafes", "Restaurants"]
"CVpKlqrjYCyjxnlkBCUK5A"	["Tattoo", "Piercing", "Beauty and Spas"]
"Cs7Jj_7dGq79GJ7JsqFb8w"	["Photographers", "Event Planning & Services"]
"CxOApc8E_VnFvwYDbaIoSw"	["Food", "Bakeries", "Delis", "American (New)", "Restaurants"]
"Cs-UYUF3mpSavDD4FELfTw"	["Food", "Coffee & Tea", "Sandwiches", "Restaurants"]
"CaAFCP3njTjs2AO20p4Ldg"	[]
"C2E1E0o-ssSrf_dokwxTXg"	["African", "Ethiopian", "Restaurants"]
"CWk6yFOoKJH5URub5XsHDg"	["Chinese", "Restaurants"]
"CyBo_6qf6A_ARgJ_vU5Ecw"	["Hotels & Travel", "Event Planning & Services", "Hotels"]
"CxELcWrHxqgFbRPdkfF8bw"	["Financial Services", "Automotive", "Towing", "Hotels & Travel", "Travel Services", "Insurance"]
"CYr_ln80SyS1B6Equ1qHUg"	["Hair Salons", "Beauty and Spas"]
"CBGlpWPSssVOV26940fcnQ"	["Arts & Entertainment"]
"CuQFZg7I6WKGFCdkyYPq6A"	["Restaurants"]
"Cmim8IrcxWZdJ6SN6CDSAw"	["Restaurants"]
"CVIXJlbQsikFI9XeElGe1g"	["American (New)", "Restaurants"]
"CvGXAEI43buE0rzo207uWA"	["Home Services", "Real Estate", "Apartments"]
"Cqri0e5NnArzmP5oq5-Lkg"	["Bars", "American (New)", "Nightlife", "Lounges", "Restaurants"]
"CToesleRmkTElhvXhA4nUw"	["Active Life", "Yoga", "Fitness & Instruction"]
"C8xsHOj5XNNZu3zQCpdkrQ"	["Food", "Coffee & Tea"]
"CIUoJUkGa6muTeiEsoY7og"	["Mass Media", "Radio Stations"]
"C13D3XuKas2K_VwK3BFLPQ"	["Dermatologists", "Doctors", "Health and Medical"]
"CicSpPgT48Gd9WbsViS2DA"	["Sushi Bars", "Japanese", "Restaurants"]
"C2uQIDpzEJu39JmGd_Cw3Q"	["Delis", "American (Traditional)", "Sandwiches", "Restaurants"]
"Ctx6jhtPjAb1WgSaNoEieQ"	[]
"CY8mBHb_9t9QbI1XUBXICg"	["Books, Mags, Music and Video", "Shopping", "Bookstores"]
"CToibRxR7WiDhiffl2JhSQ"	["Dermatologists", "Doctors", "Health and Medical", "Internal Medicine", "Family Practice"]
"CYAkYUjKTycDER_l80qP0Q"	["Fast Food", "Sandwiches", "Restaurants"]
"CkZ4EyE9bpS1Wl9zejMHfQ"	["Food", "Coffee & Tea"]
"C4XaTyBDIgpdK4H7FAdBoQ"	[]
"CXTqxjotiJOhoSoIEtBAxw"	["Fast Food", "Restaurants"]
"CKqHfvcqx73-Uz0xGMHL6Q"	["Chicken Wings", "Restaurants"]
"CcDtQxeDYlRAfZMGwqMZjA"	["Local Services", "Printing Services"]
"CbfX2Bk37IP3xbXLNnqbfQ"	["American (Traditional)", "Comfort Food", "Caterers", "Event Planning & Services", "Restaurants"]
"CFq_haGi1c_TQEWgR-pgDQ"	["Flowers & Gifts", "Shopping", "Florists"]
"CrdFtMqMa1pTS1GZ5lAwZQ"	["Breakfast & Brunch", "Diners", "Restaurants"]
"CMeTp2c7mxu9l26WUBrT6w"	["Hotels & Travel", "Bed & Breakfast", "Event Planning & Services", "Hotels"]
"CFN9_awssn6eUIEzZ_iRFQ"	["Shopping", "Luggage"]
"CiCzdCfbq1QFaJNr1DJn7w"	["Women's Clothing", "Fashion", "Shopping"]
"C883uBBYPCDOzpSk3QxAnw"	["Active Life", "Tennis"]
"CxBPeMdK7oFcDdoennTe8A"	["Sporting Goods", "Bikes", "Shopping"]
"CKtfGOtPkLnZASAPw-iXQg"	["Cafes", "Restaurants"]
"CMgiCcmL5auwuFJ74noOPg"	[]
"C-hFN_9-neNSK9hGsYMhiw"	["Health and Medical", "Laser Eye Surgery/Lasik"]
"CGXvwxL7ODvx82qTln8TSA"	["Print Media", "Mass Media"]
"CFzuVLy94kslBW9QVqDRQQ"	["Hotels & Travel", "Taxis", "Transportation"]
"CCq56RI-IOYAie9VINKzfw"	["Food", "Convenience Stores"]
"Cl9eNsG77yDH93hzmwD5gA"	["Indian", "Restaurants"]
"CfwAg7i_tEVLXwPtEgxung"	["Sporting Goods", "Bikes", "Shopping"]
"C-MWu2V3J7dLzwXDciCpDA"	["Sandwiches", "Chicken Wings", "Restaurants"]
"CSGRgZ9Hr1g18OHforJ2ZA"	["Music & DVDs", "Books, Mags, Music and Video", "Shopping"]
"C7r6tp2cgxm1_VNEQueZGg"	["Food", "Bakeries", "Coffee & Tea", "French", "Restaurants"]
"CwuNdisuchgoMQJmXslH-A"	["Vietnamese", "Malaysian", "Chinese", "Restaurants"]
"CVwKmK1HDJdGj5eY5-JtbA"	["Fashion", "Shopping", "Jewelry"]
"CEYe2iZoOdsInxU9Mlbjcw"	["Skin Care", "Day Spas", "Hair Salons", "Beauty and Spas"]
"CRrj-Tpbj54NcruRVKYW7g"	["Breakfast & Brunch", "Restaurants"]
"CHWD3d5Cqp4spKF6z7jebg"	["Health and Medical", "Dentists", "General Dentistry"]
"CPkUO2F9VENCaLXf4zj5UA"	["Food", "Ice Cream & Frozen Yogurt"]
"CUX2WCgXN8t1lvZddx_rgQ"	["Food", "Donuts"]
"C00l77_vDMEyXTtebEaNMA"	["Hobby Shops", "Shopping"]
"C_EtrXTygRX5RTUOKtO6Dg"	["Bars", "American (Traditional)", "Nightlife", "Restaurants"]
"CxJTNL-lZhD9dsqzgv_9Qg"	["Art Supplies", "Shopping", "Arts & Crafts"]
"CLw3iXC8_ucYB7NuD0wFQw"	["Hotels & Travel", "Caterers", "Event Planning & Services", "Hotels"]
"CVRBCZtmCVw6WFRWp9TpDw"	["Electronics", "Shopping", "Appliances", "Home & Garden", "Mobile Phones"]
"C58LwszasVKIqFsKfQhIGA"	["Hair Salons", "Beauty and Spas"]
"CiHA70Q73nIuBW4VlHik9g"	["Food", "Ice Cream & Frozen Yogurt"]
"CDm96_A5GagulRKa5zadfQ"	["Bars", "Nightlife"]
"Cx5KQaTZWk9SUfjO5BjVCg"	["Health and Medical", "Dentists", "General Dentistry"]
"C9KsS2_6zYeub-X7FRPQyg"	["Home Services", "Real Estate", "Apartments"]
"CU047MuCn7u-9UGA2-xhmA"	["Museums", "Arts & Entertainment"]
"CE05_kJvl0xRloi8fW6R3w"	["Auto Repair", "Automotive", "Oil Change Stations"]
"CJE1ZAEJehgzy91OlvH3gA"	["Active Life", "Parks"]
"C89rUvkbuFmbsP9qYKfX4g"	["Fast Food", "Sandwiches", "Restaurants"]
"Ckjlcv3mOPnCosSEPb4tmg"	["Mexican", "Restaurants"]
"CKtZX-G9AIOPIHPXOK56sg"	["Local Services", "Shoe Repair"]
"CZSLn0w5xUESdprbfINn8w"	["Sporting Goods", "Bikes", "Shopping"]
"CBcU0NoeZNwUDvSk8MeA5Q"	["Food", "Grocery"]
"C80OEuGcEohYs-vbgCppAg"	["Nightlife", "Korean", "Bars", "Lounges", "Restaurants"]
"C8n3oPO0RMHKVMwDkR65Dg"	["Local Services", "Printing Services"]
"CYUEDtH3q4cO_Zp0NQalIQ"	["Mass Media", "Radio Stations"]
"CKUo7hidOxWdPPu_nCTenw"	["Nightlife", "Pubs", "Irish", "Bars", "Restaurants"]
"C1OLx5RjPgBM4j9q7sg12Q"	["Middle Eastern", "Restaurants"]
"CPg2C4ye0AtMrwJJVpdRig"	["Restaurants"]
"C76xo7j-DTjI2J53xGmNCw"	["Used, Vintage & Consignment", "Fashion", "Shopping"]
"ClyX36FCGeZYYvDs8Jwx3Q"	["Music & DVDs", "Books, Mags, Music and Video", "Shopping"]
"CiS3oaKZpfgXwPjpw-Y1gA"	["Italian", "Restaurants"]
"CRMJCd47OM8AqMB8fRFuMA"	["Books, Mags, Music and Video", "Shopping", "Comic Books"]
"CT0dkF0eK30nLfnXgj3A0A"	["Auto Repair", "Automotive", "Oil Change Stations"]
"CjP2rF2NMn5XVYlJRuvZbQ"	["Food", "Bakeries", "Desserts"]
"Cbo6h9acOtsz5USDdwKmmQ"	["Colleges & Universities", "Hospitals", "Education", "Health and Medical"]
"C31ExBTn_6UxbTVkWPtNkg"	["Sushi Bars", "Japanese", "Restaurants"]
"CSH_6_oVGCBw_e_-cYfaPg"	["Colleges & Universities", "Education"]
"COD_1kEPL0nf1k-NRSKCIA"	["Electronics", "Musical Instruments & Teachers", "Shopping"]
"CgUgaSo5GyM3bKCeY7edYg"	["Sushi Bars", "Japanese", "Restaurants"]
"CBkil8Sld8afDq5hWNDdyw"	["Nail Salons", "Beauty and Spas"]
"C6ffz9ppgZHB9t1AauIVhw"	["Mexican", "Restaurants"]
"CinvebXaAbKKHROKU9VWuw"	["Local Services", "Shipping Centers", "Printing Services"]
"CmumtnKWl2ksWGWtE33Rww"	["Fast Food", "Hot Dogs", "Food Stands", "Restaurants"]
"CY9mSnFBlPiObXReo5_O6w"	["Arts & Entertainment", "Art Galleries", "Shopping", "Jewelry"]
"Cd11AiNEeUSrxoiAZxw3bw"	["Food", "Bakeries", "Coffee & Tea"]
"ChIushdacHIBnpFQmd7Q1g"	["Adult Entertainment", "Nightlife"]
"CplbSG98dX9FnP3XHc-S5g"	["Education"]
"CSoOare0D0NQiYea9HZ4yA"	["Hair Salons", "Beauty and Spas"]
"Cvj76Of5Mo9kI5f4UMim6A"	["Restaurants", "Hot Dogs"]
"CHpzvc_-F3syFrwPs-2rOQ"	["Sandwiches", "Restaurants"]
"C9NFRNs3d1FUFQgswznCrg"	["Mattresses", "Shopping", "Home & Garden", "Office Equipment"]
"CzP2dF6SYBcBEeXC1ifiTA"	["American (New)", "Nightlife", "Dance Clubs", "Restaurants"]
"Cf-RFse-TYG8FAGqHcEKVQ"	["Department Stores", "Fashion", "Shopping"]
"CjJUp3KAs-zl1WCekVVngw"	["Hotels & Travel", "Restaurants", "Event Planning & Services", "Hotels"]
"CdLwPbOEmln0VV3L8oQy_Q"	["Music & DVDs", "Books, Mags, Music and Video", "Musical Instruments & Teachers", "Shopping"]
"CtZdyDocKYqL95NHhNc5tg"	["Food", "Coffee & Tea"]
"C9h4UgyWTsVk5zszgcBv1w"	["Burgers", "Fast Food", "Restaurants"]
"CQDgwHALlXTgvfOd0HoH8g"	["Arts & Entertainment", "Cinema", "Performing Arts"]
"CLenknsOH4eklJZOqTsejw"	["Local Services", "Preschools", "Education", "Child Care & Day Care", "Elementary Schools"]
"CBk3GqDIhAxm1Sm5uWZynA"	["Pet Services", "Pet Boarding/Pet Sitting", "Pets"]
"Clh88VWrVcZHRMD9Ub9pxQ"	["Fashion", "Shopping", "Accessories"]
"CpM57zyP-QXUdGAUhh9Dyg"	["Eyelash Service", "Beauty and Spas"]
"CJ0sbMmixbh21d9fUoBEMg"	["Food", "Coffee & Tea"]
"C7FKNwSUlbUinT9cRSLXHA"	["Tapas/Small Plates", "Bars", "Nightlife", "Lounges", "Restaurants"]
"CZQ7dvsZiDDEj8mYR42OZg"	["Pakistani", "Indian", "Restaurants"]
"C-GjKp9h8eBr6NUByxNZtQ"	["Shopping", "Home Services", "Internet Service Providers", "Mobile Phones", "Professional Services", "Electronics"]
"CiFoN_1EW0W2McTJpLtN9w"	["Food", "Specialty Food", "Grocery", "Meat Shops"]
"CfXB2vQ0_wLzwhVUpkj-XA"	["Mexican", "Restaurants"]
"CObgcxFJuEXZZpm4Mw3z1A"	["Restaurants"]
"CMgjk8P9Epmn-0zBc61RkA"	["Food", "Beer, Wine & Spirits", "Bars", "Nightlife", "Wine Bars"]
"COh4RjLSsW5qCJ7JnNIsng"	["Beauty and Spas", "Hair Removal", "Medical Spas", "Skin Care", "Health and Medical", "Laser Hair Removal"]
"CRwwQ3XweXewLPOceeHu_g"	["Tires", "Automotive"]
"CJsJzlv9wZ6UwsM68btgPg"	["Musical Instruments & Teachers", "Shopping"]
"Cqb7ACDJ4M3UHzYE-Kpg7w"	["Food", "Ice Cream & Frozen Yogurt"]
"CRo00CctIXt1OVGGDczKyA"	["Doctors", "Health and Medical"]
"CJNj7-nfZZX7V1UnHm3atQ"	["Indian", "Food Stands", "Restaurants"]
"CiwfeWuF_KqGGQXTBK_0_w"	["Hotels & Travel", "Local Flavor", "Transportation"]
"ClaJQ-p5fvJfQRXUNpdWNQ"	["Home Services", "Real Estate", "Apartments"]
"Cni9GEahlVtWVDixjoYcmA"	["Doctors", "Health and Medical", "Obstetricians and Gynecologists"]
"Ckvt2gGT71Xdjqc2p1E3cA"	["Hair Salons", "Beauty and Spas"]
"C7SLHJ0GY_cnhNqDM2jSGw"	["Chinese", "Restaurants"]
"CmclEj-oP2N1MA7C2LpV5g"	["Bars", "Sports Bars", "Nightlife"]
"CJiN7ZzW_iBJue4ebTm3dw"	["Investing", "Financial Services", "Shopping", "Antiques"]
"CX9Wfu8GWXpi5y-bUjsc5A"	[]
"Cq0RSod_3ADfYMSY8QelGw"	["Pakistani", "Indian", "Restaurants"]
"CYXdwQeDSv8vtiEjRfkcOA"	["Greek", "Mediterranean", "Restaurants"]
"CEnTv6oyopMJZHmC7QRgqA"	["Shopping", "Home Services", "Internet Service Providers", "Mobile Phones", "Professional Services", "Electronics"]
"Cgk1WTJ8avHFEb9WIKoIMg"	["Active Life", "Pilates", "Yoga", "Trainers", "Fitness & Instruction"]
"Cfwl7d5HAzf2iwUcyJmmWw"	["Books, Mags, Music and Video", "Shopping", "Bookstores"]
"CS_HlBwtcbSgvfQEJIuYSQ"	["Acupuncture", "Health and Medical"]
"Ce_Ieow6V-aLUuR2rs1eFw"	["Arts & Crafts", "Shopping", "Fabric Stores", "Art Supplies"]
"CRcg6WtbcTXXtBvwfF3XTw"	["Women's Clothing", "Fashion", "Shopping", "Shoe Stores", "Accessories"]
"C1l5T3C6dU5tjS_gUKHjYg"	["Active Life", "Fitness & Instruction"]
"CC-kZ_tCh8O6kb1B6qN26w"	["Food", "Convenience Stores"]
"C79XUXMJntLlaFJ6SGDfCw"	["Mexican", "Restaurants"]
"CtuIJw9_Pwd77wRg2ap13Q"	["Doctors", "Health and Medical", "Family Practice"]
"CVG7U-Ex8-UrmxtEhXsoBw"	["Arts & Entertainment", "Art Galleries", "Shopping", "Jewelry"]
"C7SC0GWXcXmknid8ktTsaQ"	["Lounges", "Arts & Entertainment", "Bars", "Nightlife", "Music Venues"]
"CfzcG3ln3ydFUUGZWzOmvg"	["Bars", "Hookah Bars", "Nightlife"]
"CjvV9PzdSOk7gapnwS1Xww"	["American (Traditional)", "Restaurants"]
"CLfX-_6CngIOjJslhNkTCA"	["Seafood", "Steakhouses", "Restaurants"]
"CGrUzcIbTnTmTFx1QLyqbw"	["Home Services", "Real Estate", "Apartments"]
"CecrUAwLq9qh-xZOkN4nFA"	["Home Services", "Real Estate", "Apartments"]
"CxQ1m2iY4wQpXC64tSfWgQ"	["Italian", "Pizza", "Restaurants"]
"CzKVEljL8gYjkun9W2m3JA"	["Arts & Crafts", "Shopping", "Framing", "Photography Stores & Services"]
"CIkPYeRsbxfiKAw-6od-rg"	["American (New)", "Restaurants"]
"CVSTl-4XxSXA2z3Xrnak_g"	["Home Cleaning", "Local Services", "Home Services", "Pest Control"]
"Cdf50a8hswxqOa-5vAoEsg"	["Pakistani", "Indian", "Restaurants"]
"COKz45qbD_awePnSguZd5g"	[]
"Cc6GPBlYeuZIyuf0z7aoPQ"	["Food", "Ice Cream & Frozen Yogurt"]
"Cfonr0hg-2hz1yUkoDwx-w"	["Vegetarian", "American (New)", "Restaurants"]
"C8k2eso77Pkcv4csDYg2Hw"	["Bars", "Sports Bars", "Nightlife"]
"CYgWv0-ru5qujLQscQgo4g"	["Local Services", "Sewing & Alterations"]
"CUgWVhCyIVeuoP31RdaVFw"	["Italian", "Fast Food", "Restaurants"]
"C2OTZkEpsIsjCTdd6HYuBg"	["Food", "Grocery"]
"CoKXBABEs_kNIlITIS-Xlg"	["Local Services"]
"CugAHP0Dfup8ui8rcL9AQA"	["Local Services", "Dry Cleaning & Laundry"]
"CqU7SXYRo9EbMwlxrSvErA"	["American (New)", "Restaurants"]
"CVXXifbXc-_c94K3azyaMA"	["Local Services", "Dry Cleaning & Laundry"]
"CkRngbZWvrktBRQHlvg78A"	["Local Services", "Art Supplies", "Notaries", "Shopping", "Arts & Crafts"]
"Cbf0Da-d5FtQ4KgYqek5IQ"	["Doctors", "Ear Nose & Throat", "Health and Medical"]
"CnCvtvnPUm6kCMlQIxbkoA"	["Optometrists", "Health and Medical"]
"CjUHKIWesCrw-N5NceJGtQ"	["Sandwiches", "Restaurants", "Event Planning & Services", "Caterers"]
"CS0IkhLaW6VzPDmn1Qxe4A"	["Cafes", "Restaurants"]
"CvgqLb-fHhv2MTPb__Ioog"	["Hotels & Travel", "Event Planning & Services", "Hotels"]
"C6jKwYmzHztO7OCex9j-YQ"	["Italian", "Pizza", "Restaurants"]
"CJz5KjdETtHXoma4EH6KhQ"	["Active Life", "Pilates", "Fitness & Instruction"]
"CSn2-XpArLLYeZ_k2BKzrg"	["Bars", "Nightlife"]
"CHyaT8gCT-1_JhsE-IctGA"	["Hotels & Travel", "Taxis", "Airport Shuttles", "Limos", "Transportation"]
"CDfSYMoMAoaK4iYIhs4exg"	["Food", "Home Services"]
"CUhwFEU13F6NC98VkwYElg"	["Gluten-Free", "Asian Fusion", "Chinese", "Restaurants"]
"CFO9AibIRd5pPCSBNf1teQ"	["Computers", "Shopping"]
"CrXKBn6a1UaVycPh6YSyjw"	["Food", "Grocery"]
"Ce1OySu5mTlFot5sB0HcWQ"	["Active Life", "Rafting/Kayaking"]
"CLnsQyp0ndsCDFoKgrQs9g"	["Food", "Bakeries", "Pizza", "Restaurants"]
"CVwyghKKXFyWWQiI3ovaHQ"	["Home Services", "Real Estate", "Apartments"]
"CfGeAkLKLoKvzSZJxoaicQ"	["Keys & Locksmiths", "Home Services"]
"CGIFfpKkQG2p3-x0jWC9dw"	["Hotels & Travel", "Event Planning & Services", "Venues & Event Spaces", "Hotels"]
"CsciKqqj5akdAMiNUk-Xrg"	["Active Life", "Parks"]
"C2czV03pzn-7zVg_OyAqnQ"	["Women's Clothing", "Men's Clothing", "Fashion", "Shopping", "Jewelry"]
"Cf4LAGTPCOPED84FIkqTGQ"	["Security Systems", "Home Services"]
"C44mTlN9hDsy9CGlgRQ8sw"	["American (New)", "Mediterranean", "Restaurants"]
"CwcDRtNgjgM4pLS4o63g6A"	["Bars", "Sports Bars", "Nightlife"]
"CJ-UuJEEEWoSnfWsfbbeig"	["Active Life", "Amateur Sports Teams"]
